8 0 5 2 9 4 6 0 3
4 0 0 5 7 0 0 0 0
2 0 9 6 0 3 5 4 8
0 5 8 0 0 9 2 0 4
7 9 4 1 3 0 8 0 0
0 2 1 0 0 5 9 3 0
9 0 6 4 0 7 0 0 1
5 3 7 9 0 1 0 2 6
1 4 0 0 5 6 0 0 9
-
1 5 7 3 0 9 0 2 4
3 0 9 2 0 0 7 1 0
6 0 0 7 0 0 9 3 8
0 2 0 5 6 7 0 0 3
4 0 3 8 0 0 5 9 0
5 0 8 0 3 4 2 0 0
7 1 5 0 9 0 8 0 0
0 9 6 0 0 5 0 4 7
2 3 0 0 7 8 1 5 9
-
7 1 5 3 9 8 0 2 0
6 2 0 4 0 0 3 1 0
0 0 0 6 2 1 7 0 0
1 0 7 9 0 3 5 8 2
3 4 2 0 8 5 0 0 7
5 0 8 0 7 0 0 0 3
4 0 0 8 0 9 2 3 5
0 8 3 0 1 0 6 7 0
2 5 6 7 0 4 0 9 1
-
6 1 7 8 3 2 4 0 0
2 0 0 7 0 9 0 1 6
5 8 9 1 4 6 0 0 3
3 4 0 0 8 0 0 6 0
0 2 8 0 0 0 7 0 4
9 7 0 3 0 4 0 2 8
7 9 3 0 2 8 6 0 0
8 5 0 9 6 0 3 4 0
0 0 1 0 7 0 9 8 2