4 0 0 5 0 0 7 0 8
2 0 0 0 0 0 0 0 0
0 0 0 0 0 0 0 0 5
0 0 0 0 0 0 0 0 0
0 0 0 0 0 0 6 0 0
0 0 0 3 0 4 0 5 2
1 0 7 0 8 0 0 6 0
0 0 4 0 3 0 0 2 0
0 2 0 0 0 7 0 0 0
-
9 0 0 0 5 7 2 0 3
2 0 0 0 1 0 0 0 0
0 0 0 0 0 0 0 0 5
0 0 0 0 0 4 0 0 0
0 0 0 0 8 0 0 4 0
0 0 0 0 0 0 6 0 0
6 0 0 0 0 0 0 0 2
0 2 0 0 0 0 0 0 0
0 9 0 0 0 0 0 0 0
-
3 0 0 0 0 0 0 0 0
0 7 0 0 0 0 0 0 0
8 0 0 0 0 0 0 7 0
0 0 0 0 8 0 0 0 0
0 0 0 0 0 0 0 0 7
7 0 0 0 0 6 0 0 0
2 0 0 0 0 0 0 0 0
0 0 0 0 0 9 6 0 2
0 0 0 0 0 0 7 0 0
-
7 5 0 0 0 0 2 0 0
0 0 0 0 0 0 0 0 0
0 9 0 0 0 2 0 0 0
0 0 0 0 0 0 0 0 0
0 0 0 0 0 0 0 0 4
0 0 0 0 0 0 0 0 0
0 3 0 2 0 0 0 0 0
4 0 0 1 0 0 0 0 5
5 0 0 0 0 0 0 0 0