2 5 7 0 0 0 6 1 0
0 0 9 0 6 0 0 5 0
4 0 0 0 0 2 7 0 0
9 0 0 0 0 0 0 0 4
0 4 0 8 0 3 5 0 6
0 0 0 0 0 0 0 0 0
5 9 0 0 0 8 0 6 0
1 0 4 0 0 0 2 3 0
0 0 2 3 0 0 0 4 0
-
6 5 0 0 2 3 7 0 0
0 0 2 0 5 0 0 0 0
4 0 0 8 0 0 0 0 2
1 6 5 0 0 0 2 0 7
2 0 4 1 0 5 0 0 0
0 0 3 6 4 2 0 0 0
0 4 0 2 0 7 0 0 5
5 0 6 0 8 0 0 0 9
9 0 0 0 0 1 0 0 0
-
3 2 5 1 0 0 0 7 8
1 4 0 0 0 0 0 2 9
6 9 0 0 2 0 0 0 3
0 1 0 6 7 0 0 0 0
0 0 2 0 0 0 0 6 0
8 7 0 0 0 0 0 1 2
5 0 0 0 4 0 8 0 0
7 0 0 5 0 9 0 0 0
2 0 0 0 0 7 0 0 1
-
2 0 0 1 4 0 0 7 9
0 0 4 9 0 7 0 0 0
1 0 0 5 0 0 8 3 4
0 0 0 8 5 0 0 0 0
7 5 0 0 0 0 1 0 0
9 3 0 0 6 1 4 0 0
6 0 0 0 9 8 0 0 3
0 2 0 0 0 4 0 8 0
8 0 0 0 7 0 9 2 0
-
1 0 0 4 0 6 9 0 7
0 0 5 0 2 9 1 0 0
0 0 0 0 0 0 2 4 5
6 1 8 0 0 0 4 0 0
9 0 0 5 0 4 0 0 0
4 0 0 0 0 1 0 0 0
0 7 0 0 0 0 5 9 0
3 0 6 0 4 0 7 0 0
5 0 4 0 0 7 0 6 0
-
5 8 7 0 3 0 0 0 1
9 1 0 0 7 5 0 0 8
0 2 0 9 1 0 0 0 0
0 0 0 0 8 0 3 0 0
0 0 9 0 0 3 8 0 0
3 0 0 1 0 0 0 0 0
0 6 0 0 0 4 0 3 0
7 9 4 0 2 0 0 8 6
2 0 0 8 0 6 0 4 0
-
6 0 9 0 0 1 0 4 5
7 0 0 2 0 0 0 0 0
2 4 0 9 6 0 8 0 0
4 5 7 0 0 0 0 0 0
0 0 0 0 7 0 0 0 3
0 0 0 8 0 4 7 5 0
8 0 4 0 0 0 0 0 7
0 9 0 0 0 7 6 0 2
0 0 0 0 2 0 0 0 0